####################
#_________________M#
#_################_#
#_#______________#_#
#_#_############_#_#
#_#_#P_________#_#_#
#_#_#_########_#_#_#
#_#_#________#_#_#_#
#___##########___#_#
####################
