####################
#M_______________#_#
################_#_#
#______________#_#_#
#_############_#_#_#
#P_________#___#_#_#
##########_#_###_#_#
#________#_#_#___#_#
#_########_____###_#
####################
