####################
#_______#__________#
#_#####_#_########_#
#_#___#_#_#______#_#
#_#_#_#_#_#_####_#_#
#_#_#_#___#_#__M_#_#
#_#_#_#####_#_####_#
#_#_#_______#______#
#P__#########_####_#
####################
